####...####
#.........#
#.........#
#.........#
#.........#
....#.#....
.....@.....
....#......
#.........#
#.........#
#.........#
#.........#
####...####