###########
#.........#
##.#####.##
#...@..#..#
#########.#
#.........#
###.#######
#.#.#...#.#
#.....##..#
###########