##############
#............#
##.######.##.#
#...@..##....#
#########.##.#
#............#
###.#####.##.#
#.......#.##.#
#............#
##############